1111111111111111111111
10C00000000110011100C1
10000P0010000000000011
1111111111000000111111
10000000100000000C00E1
100C001110000001111111
10000000000C0000000001
1111111111111111111111