111111111111111111111111111111111111111111
1E00000000000000000000000000000000000001C1
111101111110111111111111111000000000000101
110000000010000000011111111001000000001001
111111111011111111001111111000000000000001
1C0000011001000000000000000000000000000001
111110110011111111111111101111110000111111
100000000000000000000000000011000000001111
100000000000000C00000000000100111000011111
111100000000000000000000000110100000000011
100000000111111110001100000000000111111111
111111011111111100101111111101111111111111
1C000000000011C00100110000000000000000P011
111111111111111111111111111111111111111111