1111111111111
100000E000P01
10C001C100001
1111111111111