1111111111111
1000000000P01
10E0000000001
1111111111111