1111111111111111111111111111111111111111111111111111111111111111111111
100000000000000E00P0C0000000000000000000000000000000000000000000000001
1111111111111111111111111111111111111111111111111111111111111111111111